        111111E111111111111111111
        1000000000110000000000001
        1111000001110000002000001
        1001000000000000000000001
111111111011000001110000000000001
100000000011000001110111111111111
11111111111111011100000010001
11110110111111011101010010001
11000000110101011100000010001
10002220000000001100000010001
10000000000000001101010010001
110000011101010111110111100011
11110111 1110101 101111010001
11111111 1111111 111111111111

-------------------------------------
        1111111111111111111111111
        1000000000110000000000001
        1111000001110000002000001
        100100000000000000000000E
111111111011000001110000000000001
100000000011000001110111111111111
11111111111111011100000010001
11110110111111011101010010001
11000000110101011100000010001
10002220000000001100000010001
10000000000000001101010010001
110000011101010111110111100011
11110111 1110101 101111010001
11111111 1111111 111111111111

-------------------------------------
        1111111111111111111111111
        1000000000110000000000001
        1111000001110000002000001
        1001000000000000000000001
111111111011000001110000000000001
100000000011000001110111111111111
11111111111111011100000010001
11110110111111011101010010001
11000000110101011100000010001
10002220000000001100000010001
10000000000000001101010010001
110000011101010111110111100011
11110111 1110101 101111010001
11111111 111E111 111111111111

-------------------------------------
        1111111111111111111111111
        1000000000110000000000001
        1111000001110000002000001
        1001000000000000000000001
111111111011000001110000000000001
100000000011000001110111111111111
11111111111111011100000010001
11110110111111011101010010001
E1000000110101011100000010001
10002220000000001100000010001
10000000000000001101010010001
110000011101010111110111100011
11110111 1110101 101111010001
11111111 1111111 111111111111

-------------------------------------
        1111111121111111111111111
        1000000000110000000000001
        1111000001110000002000001
        1001000000000000000000001
111111111011000001110000000000001
10000000001100E001110111111111111
11111111111111011100000010001
11110110111111011101010010001
11000000110101011100000010001
10002220000000001100000010001
10000000000000001101010010001
110000011101010111110111100011
11110111 1110101 101111010001
11111111 1111111 111111111111

-------------------------------------
        1111111111111111111111111
        1000000000110000000000001
        1111000001110000002000001
        1001000E00000000000000001
111111111011000001110000000000002
100000000011000001110111111111111
11111111111111011100000010001
11110110111111011101010010001
11000000110101011100000010001
10002220000000001100000010001
10000000000000001101010010001
110000011101010111110111100011
11110111 1110101 101111010001
11111111 1111111 111111111111

-------------------------------------
        1111111111111111111111111
        1000000000110000000000001
        1111000001110000002000001
        1001000000000000000000001
111111111011000001110000000000001
10000000001100E001110111111111111
11111111111111011100000010001
11110110111111011101010010001
11000000110101011100000010001
10002220000000001100000010001
10000000000000001101010010001
110000011101010111110111100011
11110111 1110101 101111010001
11111111 1112111 111111111111

-------------------------------------
        1111111111111111111111111
        1000000000110000000000001
        1111000001110000002000001
        1001000000000000000000001
111111111011000001110000000000001
10000000001100E001110111111111111
11111111111111011100000010001
11110110111111011101010010001
11000000110101011100000010001
20002220000000001100000010001
10000000000000001101010010001
110000011101010111110111100011
11110111 1110101 101111010001
11111111 1111111 111111111111

-------------------------------------

        1111111111111111111111111
        1000000000110000000000001
        1111000001110000002000001
        1001000000000000000000001
111111111011000001110000000000001
10000000001100E001110111111111111
11111111111111011100000010001
11110110111111011101010010001
11000000110101011100000010001
10002220000000001100000010001
1000000000N000001101010010001
110000011101010111110111100011
11110111 1110101 101111010001
11111111 1111111 111111111111

-------------------------------------

        1111111111111111111111111
        1000000000110000000000001
        1111000001110000002000001
        1001000000000000000000001
111111111011000001110000000000001
100000000011000001110111111111111
11111111111111011100000010001
11110110111111011101010010001
11000000110101011100000010001      11111111
1000222000000000110000001000N      10000001
10000000000000001101010010001      10000001   
110000011101010111110111100011     11111111
11110111 1110101 101111010001
11111111 1111111 111111111111

-------------------------------------

        1111111111111111111111111
        1000000000110000000000001
        1111000001110000002000001
        1111111111111111111111111

111111111111111111111111111111111
100000000011000001110111111111111
11111111111111011100000010001
11110110111111011101010010001
11000000110101011100000010001      11111111
10002220000000001100000010001      10000001
10000000000E00001101010010001      10000001   
110000011101010111110111100011     11111111
11110111 1110101 101111010001
11111111 1111111 111111111111
